20 15
.........N..........
.O                 .
.                  .
.        .         .
.        .         .
.        Z         .
.        .         .
E     C  .  P      .
.        .         .
.        Z         .
.        .         .
.        .         .
.                  .
.                  .
....................

N room11
E room9
