20 15
....................
..Z              Z..
.Z       Z        Z.
.                  .
.                  .
.        C         .
.                  .
. Z    C X C       E
.                  .
.        C         .
.                  .
.                  .
.Z       Z        Z.
..Z              Z..
....................

E room2
