20 15
....................
.           .    P .
Z  ......   .      .
. C.               .
.  .   .    .    P .
. ..   .    ........
.      .           .
W      ......      E
.      .    .      .
.....  .  P .     P.
.       CCCC........
.                  .
......Z..          .
. PP             J .
..........S.........

W room1
S room3
E room5
