20 15
....................
.PPP .        . PPP.
.PP  .        .  PP.
.P   .        .   P.
.        PP        .
....    PPPP    ....
.PP    PPPPPP    PP.
.PP     PPPP     PP.
.PP    PPPPPP    PP.
....    PPPP    ....
.        PP        .
.P   .        .   P.
.PP  .        .  PP.
.PPP .        . PPP.
.........S..........

S room7
