20 15
........N...........
.                 C.
.                  .
....Z GG Z GG Z GG Z
.P                 .
.P                 .
.........          .
.   G  ..  .   .   .
W   G  ..  .P  .   .
.   G  ..  Z . Z   .
....G  ..  .PPP.   .
.PP..  ..  .CCC.   .
.P  .  ..         Z.
.                Z..
....................

N room2
W room4
