20 15
....................
.O.     .          .
.     C   ......   .
.   ....       .   .
.   .        ....  .
. ...  ....        .
.   .     . Z      .
W   .  P  .   ...  E
.  C... ...   .P.  .
.     .   ..  .C.  .
..   .   .....  .  .
.P.      ..        .
. .   ....   ..    .
.     .       .    .
.........S..........

N room6
E room5
W room1
S room3
