20 15
....................
.PC    P   P   .   .
.C  . ........ Z . .
. .   .    . .   . .
.      ...   ..... .
. . .C   ..        .
.   C ..  ...  C....
.....  .   CP.     E
.PC   .C  ....... ..
...C....        .  .
.O. C  ..  .... .. .
. . .    . .    P. .
. CC.... . . ....  .
. C        .      ..
....................

E room3
