20 15
....................
.                  .
.    PPPP     PPPP .
.  PPPPPP   PPPPPP .
. PPPP     PPPP    .
.PPP      PPP      .
.PP  PPPP PP  PPPP .
.PP   PP  PP   PP  .
.PP     P PP     P .
.PPP  PPP PPP  PPP .
. PPPPPP   PPPPPP  .
.  PPP      PPP    .
.                  .
.                  .
.........S..........

S room15
