20 15
....................
.                  .
.                  .
.        .         .
.        .    X    .
.        Z         .
.        .         .
.     C  .  P      E
.        .         .
.        Z         .
.        .         .
.        .         .
.             GGGGG.
.             G  PO.
....................

E room2
