20 15
....................
.P                P.
.P                P.
..                ..
. ...   .  .   ... .
.O   ..  ..  ..   O.
.     P.    .P     .
.                  .
.     P.    .P     .
.O  ...      ...  O.
. ..     ..     .. .
..  C          C  ..
.P   C        C   P.
.   C          C   .
..........S.........

S room15
