20 15
....................
.           .    P .
.           .      .
.  Z.....   C      .
.  .P       .    P .
.C..P       ........
.   ....           .
W      ......      E
.      .    .      .
..Z..  .  P .     P.
.   C   CCCC........
.P   C             .
.........          .
. PP             J .
..........S.........

W room1
S room3
E room5
