20 15
.........N..........
.P   ...M  ...  ..P.
.     ...Y...    Z .
.       .CC        .
......  ...C .   ...
.    P.     ...... .
W     .C......C   C.
.C .  .C    .... . .
.  Z  .C.G.C. .. . .
.  Z C. GMGCC  . . .
.C Z  . .G.C.  . . .
.Z   C.     .    . .
..Z  ............. .
..Z                .
....................

N room16
W room6
