.........N..........
.O.     .          .
.     C   ......   .
.              .   .
.   .        ....  .
. PPPPPPPPPPPP     .
.   .     . Z      .
W   .  P  .   ...  .
.  C... ...   .P.  .
.     .   ..  .C.  .
..   .   .....  .  .
............       .
. .   ....   ..    .
.     .            .
....................
@Wrooms/room4.txt