..........N.........
.                  .
.         Z    X   .
.         Z        .
.         Z        .
.         Z        .
.         Z        .
.         Z        .
W         Z        .
.         Z        .
.         Z        .
.         Z        .
.         Z        .
.                  .
....................
@Wrooms/room4.txt