10 10
....N.....
.        .
.        .
.        .
W        .
.        .
.        .
.        .
.........

N room2
W room4
