20 15
.........N..........
.QQQQQQQQ .QQQQQQQQ.
.QQQQQQQQQ.QQQQQQQQ.
.QQQ.......QQQ..QQQ.
.QQQQQQQQQQQQQ..QQQ.
.QQQQQQQQQQQQQ..QQQ.
.....QQQ........QQQ.
W QQ.QQQ.QQQQQQQQQQ.
.QQQ.QQQ.QQQQQQQQQQ.
.QQQ.PPP.QQQZ.....Q.
.QQQ.....QQQ..QQQQQ.
.QQQQQQQQQQQ..QQQQQ.
.QQQQQQQQQQQQQQQ.CC.
.QQQQQQQQQQQQQQQ.CO.
....................

N room6
W room2
