20 15
....................
.                  .
.         Z    X   .
.         Z        .
.         Z        .
.         Z        .
.         Z        .
W         Z        E
.         Z        .
.         Z        .
.         Z        .
.         Z        .
.         Z        .
.                  .
..........S.........

W room1
S room3
E room5
