.........N..........
.                  .
.         Z    X   .
.         Z        .
.         Z        .
.         Z        .
.         Z        .
.         Z        E
.         Z        .
.         Z        .
.         Z        .
.         Z        .
.         Z        .
.                  .
....................
@Nrooms/room3.txt

