20 15
....................
.O                 .
.    P        P    .
.        .         .
.        .         .
.        Z         .
.        .         .
.     C  .  P      .
.        .         .
.        Z         .
.        .         .
.        .         .
.     P     P      .
.                  .
.........S..........

S room7
