....................
.O                 .
.                  .
.        .         .
.        .         .
.        Z         .
.        .         .
W     C  .  P      E
.        .         .
.        Z         .
.        .         .
.        .         .
.                  .
.                  .
....................
@Erooms/room2.txt
