20 15
..........N.........
.                  .
.                  .
.                  .
.                  .
.                  .
.                  .
.                  .
W                  .
.                  .
.                  .
.                  .
.                  .
.                  .
....................

N room2
W room4
