20 15
....................
.                  .
.         Z        .
.                  .
.         Z        .
.                  .
.         Z        .
W                  E
.         Z        .
.                  .
.         Z        .
.                  .
.                  .
.                  .
..........S.........

W room1
S room3
E room5
