20 15
....................
.           C P  P .
.           C      .
.   Z...    C      .
.   .P C     C   P .
..C.....      ......
.      ..         ..
W       ..         E
.        ..       ..
.....     ..........
.   C         C  PP.
.P   C       . CCCC.
. P  C     ...C    .
.P   C     ...C  J .
........S...........

W room1
S room3
E room5
