.........N..........
.                  .
.                  .
.        .         .
.        .    X    .
.        Z         .
.        .         .
.     C  .  P      E
.        .         .
.        Z         .
.        .         .
.        .         .
.                  .
.                  .
....................
@Erooms/room2.txt
@Nrooms/room2.txt
