20 15
.........N..........
.QQQQQQQQ QQQQQQQQQ.
.QQQQQQQQQQQQQQQQQQ.
.QQQQQQQQQQQQQQQQQQ.
.QQQQQQQQQQQQQQQQQQ.
.QQQQQQQQQQQQQQQQQQ.
.QQQQQQQQQQQQQQQQQQ.
W QQQQQQQQQQQQQQQQQ.
.QQQQQQQQQQQQQQQQQQ.
.QQQQQQQQQQQQQQQQQQ.
.QQQQQQQQQQQQQQQQQQ.
.QQQQQQQQQQQQQQQQQQ.
.QQQQQQQQQQQQQQQQQQ.
.QQQQQQQQQQQQQQQQQQ.
....................

N room6
W room2
