20 15
....................
.                  .
.                  .
.        .         .
.        .    X    .
.        Z         .
.        .        ..
.O    C  .  P      E
.        .        ..
.        Z         .
..U.......         .
.QQQQ.   .         .
..U... PP.    GGGGG.
.      PP.    G  PO.
....................

E room2
