.........N..........
.                  .
.    J             .
.        .         .
.        .    X    .
.        Z         .
.        .         .
.     C  .  P      E
.        .         .
.        Z         .
.        .         .
.GGG     .         .
.  G               .
.O G               .
....................
@Erooms/room2.txt
@Nrooms/room2.txt
