20 15
....................
..Z              Z..
.Z                Z.
.   Z.Z      Z.Z   .
.   .C.      .C.   .
.   Z.Z      Z.Z   .
.                  .
.                  E
.   ...      ...   .
.    ...    ...    .
.     ........     .
.      ......      .
.Z                Z.
..Z      X   F   Z..
....................

E room2
