....................
.                  .
.         Z       .
.         Z        .
.         Z        .
.         Z        .
.         Z        .
.         Z        .
W         Z        .
.         Z        .
.         Z        .
.         Z        .
.         Z        .
.                  .
..........S.........
@Wrooms/room4.txt