20 15
....................
. .       ..       .
. C  .. .P..   .   .
.C..... ....   .   .
.     .   .    .C  .
...   .   .   ..CC .
.PG   Z   Z   Z. ...
.PG   Z C Z   .. . E
.PG   Z   Z    . . .
....  .   .PP. . . .
.   . .  C.... . . .
. .   . CCC  . . . .
. ......... .. . . .
.         .    .   .
.........S..........

E room15
S room5
